0 0 0 0 16 16 16 16 0 0 0 16 0 0 0 0 4 7 0
16 16 16 16 16 16 16 16 16 0 0 0 0 0 0 0 4 7 0
0 0 60 36 36 60 0 0 0 0 36 0 0 32 0 0 2 5 0
0 127 65 93 85 69 125 1 0 0 0 0 16 0 0 0 0 7 0
0 0 8 28 8 0 0 0 0 0 8 20 8 0 0 0 3 3 1
0 2 6 12 24 48 96 0 0 0 0 0 0 0 64 0 1 1 2
-1 -127 -127 -127 -127 -127 -127 -1 -127 0 0 0 0 0 0 -127 0 1 0
0 0 14 10 62 40 56 0 0 0 2 8 20 8 32 0 3 4 1
0 28 20 119 65 119 20 28 0 0 20 34 0 34 20 0 4 3 1
0 0 62 42 62 42 62 0 0 0 34 8 20 8 34 0 3 4 0
0 24 60 102 102 60 24 0 0 24 0 66 66 0 24 0 2 3 1
0 32 32 62 40 248 8 8 0 32 0 2 0 -128 0 8 3 3 1